10 10
4 9
4 4 4 4 4 4 4 4 4 4
4 0 0 4 2 4 0 0 0 4
4 0 0 4 5 4 0 0 0 4
4 0 0 0 0 0 0 0 0 4
4 0 5 0 0 0 0 0 0 4
4 0 0 0 0 0 0 0 0 4
4 0 0 0 6 0 0 0 0 4
4 0 0 0 0 0 0 6 0 4
4 0 0 0 0 0 0 0 0 4
4 4 4 4 0 4 4 4 4 4