10 10
3 3 3 3 3 3 3 3 3 3
3 0 0 3 2 3 0 0 0 3
3 0 0 3 1 3 0 0 0 3
3 0 0 0 0 0 0 0 0 3
3 0 0 0 0 0 0 0 0 3
3 0 0 0 0 0 0 4 0 3
3 0 0 0 0 0 0 0 0 3
3 0 0 0 0 0 0 5 0 3
3 0 0 0 0 0 0 0 0 3
3 3 3 3 0 3 3 3 3 3