23 23
11 22
4 4 4 4 4 4 4 4 4 4 4 2 4 4 4 4 4 4 4 4 4 4 4
4 7 7 7 7 7 7 7 7 7 4 3 4 7 7 7 7 7 7 7 7 7 4
4 7 0 0 0 0 0 0 0 0 7 0 0 0 7 0 0 0 0 7 0 7 4
4 7 0 7 0 7 7 7 7 0 7 0 7 0 7 0 7 7 7 7 0 7 4
4 7 0 7 0 7 0 0 7 0 7 7 7 0 7 0 7 0 0 0 0 7 4
4 7 0 7 0 7 7 0 7 0 0 0 7 0 7 0 7 7 7 7 0 7 4
4 7 7 7 0 0 0 0 7 7 7 0 7 0 7 0 0 0 0 0 0 7 4
4 7 0 7 7 7 7 7 7 0 7 0 7 0 7 7 7 7 7 7 0 7 4
4 7 0 7 0 7 0 0 0 0 7 0 0 0 7 0 0 0 0 7 0 7 4
4 7 0 7 0 7 0 7 7 7 7 7 7 7 7 7 7 7 0 7 0 7 4
4 7 0 7 0 7 0 0 0 0 0 0 0 7 0 0 0 7 0 7 0 7 4
4 7 0 7 0 7 7 7 0 7 0 7 0 7 0 7 0 7 0 7 0 7 4
4 7 0 7 0 0 0 0 0 7 0 7 0 7 0 7 0 7 0 7 0 7 4
4 7 0 7 7 7 7 7 7 7 0 7 0 0 0 7 0 7 0 7 0 7 4
4 7 0 0 0 0 0 0 0 0 0 7 7 7 7 7 0 7 0 7 0 7 4
4 7 0 7 7 7 7 7 7 7 7 7 0 0 0 0 0 7 0 7 0 7 4
4 7 0 0 0 0 0 0 0 0 7 0 0 7 7 7 7 7 0 7 0 7 4
4 7 0 7 7 7 7 7 7 0 7 0 7 7 0 0 0 0 0 7 0 7 4
4 7 0 7 0 0 0 0 0 0 7 0 7 0 0 7 7 7 7 7 0 7 4
4 7 0 7 7 7 7 7 7 7 7 0 7 7 0 0 0 0 0 7 0 7 4
4 7 0 0 0 0 0 0 0 0 0 0 0 7 7 7 0 7 0 0 0 7 4
4 7 7 7 7 7 7 7 7 7 7 0 0 0 0 0 0 7 7 7 7 7 4
4 4 4 4 4 4 4 4 4 4 4 0 4 4 4 4 4 4 4 4 4 4 4