30 30
14 29
4 4 4 4 4 4 4 4 4 4 4 4 4 4 2 4 4 4 4 4 4 4 4 4 4 4 4 4 4 4
4 4 4 4 4 4 4 4 4 4 4 4 4 4 5 4 4 4 4 4 4 4 4 4 4 4 4 4 4 4
4 0 0 0 0 0 0 0 0 0 0 0 0 0 0 0 0 0 0 0 0 0 0 0 0 0 0 0 0 4
4 7 7 7 7 7 7 7 7 4 0 4 7 7 7 7 7 7 7 7 7 7 7 7 7 7 7 7 0 4
4 0 0 0 0 0 0 0 0 7 0 7 0 7 0 0 0 0 0 7 0 0 0 7 0 0 0 0 0 4
4 0 4 7 7 7 7 7 7 7 0 7 0 7 0 4 7 7 0 7 0 7 0 7 0 7 7 7 7 4
4 0 7 0 0 0 0 0 0 7 0 0 0 7 0 7 0 0 0 7 0 7 0 7 0 0 0 0 0 4
4 0 7 7 7 7 7 4 0 7 7 7 7 4 0 7 0 7 7 7 0 4 7 7 7 7 0 7 0 4
4 0 7 0 0 0 0 7 0 7 0 0 0 0 0 7 0 0 0 7 0 0 0 0 0 7 0 7 0 4
4 0 7 0 4 7 0 7 0 7 0 4 7 7 7 7 7 7 7 7 7 7 7 4 0 7 0 7 0 4
4 0 7 0 7 0 0 7 0 0 0 7 0 0 0 0 0 7 0 0 0 0 0 7 0 7 0 7 0 4
4 0 7 0 7 0 7 7 7 4 0 7 0 4 7 7 0 7 0 7 7 4 0 7 0 7 0 7 0 4
4 0 7 0 7 0 0 0 0 7 0 0 0 7 0 0 0 7 0 0 0 7 0 7 0 7 0 7 0 4
4 0 7 0 4 7 7 7 0 7 7 7 7 7 0 7 7 7 7 4 0 7 0 7 0 7 0 7 0 4
4 0 7 0 0 0 7 0 0 7 0 0 0 7 0 0 0 0 0 7 0 7 0 7 0 4 7 7 0 4
4 0 0 0 7 0 7 0 7 4 0 7 0 7 0 7 0 7 7 7 0 7 0 7 0 0 0 7 0 4
4 7 7 7 4 0 7 0 7 0 0 7 0 0 0 7 0 0 0 7 0 7 0 7 0 7 0 7 0 4
4 0 0 0 0 0 7 7 7 7 7 7 7 7 7 7 7 4 0 7 0 7 0 7 0 7 0 7 0 4
4 7 7 7 7 7 7 0 0 0 0 0 0 0 0 7 0 7 0 0 0 7 0 7 0 7 0 7 0 4
4 0 0 0 0 0 4 7 7 4 0 7 0 7 0 7 0 7 7 7 7 7 0 4 7 4 0 7 0 4
4 7 4 0 7 0 0 7 0 7 0 7 0 7 0 0 0 7 0 0 0 7 0 0 0 0 0 7 0 4
4 0 7 0 7 4 0 7 0 7 0 7 0 4 7 7 0 7 0 7 7 7 0 4 7 7 7 7 0 4
4 0 7 0 0 7 0 7 0 0 0 7 0 0 0 7 0 7 0 0 0 7 0 7 0 0 0 7 0 4
4 0 4 7 0 7 0 7 7 7 7 7 7 7 7 7 0 4 7 4 0 7 0 7 0 7 0 7 0 4
4 0 0 0 0 7 0 0 0 0 0 7 0 0 0 7 0 0 0 7 0 7 0 0 0 7 0 7 0 4
4 0 7 7 7 7 7 4 0 7 0 7 0 7 0 7 7 4 0 7 0 7 7 7 7 7 0 7 0 4
4 0 0 7 0 0 0 7 0 7 0 0 0 7 0 0 0 7 0 0 0 7 0 0 0 7 0 7 0 4
4 7 0 7 0 7 0 7 0 4 7 7 7 7 7 7 0 7 0 7 7 4 0 7 0 7 0 7 0 4
4 0 0 0 0 7 0 7 0 0 0 0 0 7 0 0 0 7 0 0 0 0 0 7 0 0 0 7 0 4
4 4 4 4 4 4 4 4 4 4 4 4 4 4 0 4 4 4 4 4 4 4 4 4 4 4 4 4 4 4