11 11
5 10
4 4 4 4 4 2 4 4 4 4 4
4 0 0 0 4 0 4 0 0 0 4
4 0 0 0 4 6 4 0 0 0 4
4 0 4 4 4 0 4 4 4 0 4
4 0 4 0 0 0 0 0 4 0 4
4 0 4 0 6 6 6 0 4 0 4
4 0 4 0 0 0 0 0 4 0 4
4 0 4 4 4 0 4 4 4 0 4
4 0 0 0 4 0 4 0 0 0 4
4 0 0 0 4 0 4 0 0 0 4
4 4 4 4 4 0 4 4 4 4 4