21 21
18 20
4 4 4 4 4 4 4 4 4 4 4 4 4 4 4 4 4 4 4 4 4
4 0 0 0 0 0 0 0 0 0 0 0 0 0 0 0 0 4 0 5 2
4 0 0 0 0 0 0 0 0 0 0 0 0 0 0 0 0 0 0 4 4
4 0 0 0 0 0 0 0 0 0 0 0 0 0 0 0 0 4 0 4 4
4 0 0 0 0 0 0 0 0 0 0 0 0 0 0 0 0 4 0 4 4
4 0 0 0 0 0 0 0 0 0 0 0 0 0 0 0 0 4 6 4 4
4 0 0 0 0 0 0 0 0 0 0 0 0 0 0 0 0 4 0 4 4
4 0 0 0 0 0 0 0 0 0 0 0 0 0 0 0 0 4 0 4 4
4 0 0 0 0 0 0 0 0 0 0 0 0 0 0 0 0 4 0 4 4
4 0 0 0 0 1 0 0 0 0 0 0 6 0 0 0 0 4 0 4 4
4 0 0 0 0 0 0 0 0 0 0 0 0 0 0 0 0 4 0 4 4
4 0 0 0 0 0 0 0 0 0 0 0 0 0 0 0 0 4 0 4 4
4 0 0 0 0 0 0 0 0 0 0 0 0 0 0 0 0 4 0 4 4
4 0 0 0 0 0 0 0 0 0 0 0 0 0 0 0 0 4 0 4 4
4 0 0 0 0 0 0 0 0 0 0 0 0 0 0 0 0 4 0 4 4
4 0 0 0 0 0 0 0 0 0 0 0 0 0 0 0 0 4 0 4 4
4 0 0 0 0 0 0 0 0 0 0 0 0 0 0 0 0 4 0 4 4
4 0 0 0 0 0 0 0 0 0 0 0 0 0 0 0 0 4 0 4 4
4 0 0 0 0 0 0 0 0 0 0 0 0 0 0 0 0 4 0 4 4
4 0 0 0 0 0 0 0 0 0 0 0 0 0 0 0 0 4 0 4 4
4 4 4 4 4 4 4 4 4 4 4 4 4 4 4 4 4 4 0 4 4