11 11
5 10
4 4 4 4 4 2 4 4 4 4 4
4 0 0 0 4 0 5 0 0 0 4
4 0 0 0 4 4 4 4 4 0 4
4 0 0 0 0 0 0 0 4 0 4
4 0 0 0 0 0 0 0 4 0 4
4 0 0 0 0 0 0 0 6 1 4
4 0 0 0 0 0 0 0 4 0 4
4 0 0 0 0 0 0 0 4 0 4
4 0 0 0 4 0 4 4 4 0 4
4 0 0 0 4 0 0 0 0 0 4
4 4 4 4 4 0 4 4 4 4 4