29 29
14 28
0 0 0 0 0 0 0 0 0 0 0 0 0 0 0 0 0 0 0 0 0 0 0 0 0 0 0 0 0
0 0 0 0 0 0 0 0 0 0 4 4 4 4 4 4 4 4 4 0 0 0 0 0 0 0 0 0 0
0 0 0 0 0 0 0 4 4 4 0 0 0 0 0 0 0 0 0 4 4 4 0 0 0 0 0 0 0
0 0 0 0 0 4 4 0 0 0 0 0 0 0 0 0 0 0 0 0 0 0 4 4 0 0 0 0 0
0 0 0 0 4 0 0 0 0 0 0 0 0 0 0 0 0 0 0 0 0 0 0 0 4 0 0 0 0
0 0 0 4 0 0 0 0 0 0 0 0 0 0 0 0 0 0 0 0 0 0 0 0 0 4 0 0 0
0 0 4 0 0 0 0 0 0 0 0 0 0 0 0 0 0 0 0 0 0 0 0 0 0 0 4 0 0
0 4 0 0 0 0 0 0 0 0 0 0 0 0 0 0 0 0 0 0 0 0 0 0 0 0 0 4 0
0 4 0 0 0 0 0 0 0 0 0 0 0 0 0 0 0 0 0 0 0 0 0 0 0 0 0 4 0
4 0 0 0 0 0 0 0 0 0 0 0 0 0 0 0 0 0 0 0 0 0 0 0 0 0 0 0 4
4 0 0 0 0 0 0 0 0 0 0 0 0 0 0 0 0 0 0 0 0 0 0 0 0 0 0 0 4
4 0 0 0 0 0 4 4 4 4 4 0 0 0 0 0 0 0 4 4 6 4 4 0 0 0 0 0 4
4 0 0 0 4 4 4 4 4 4 4 4 0 0 0 0 0 4 4 6 6 6 4 4 4 0 0 0 4
4 0 0 4 4 4 4 4 4 4 4 4 0 0 0 0 0 4 6 6 6 6 4 4 4 4 0 0 4
4 0 0 4 4 4 4 4 4 4 4 4 0 0 0 0 0 4 6 6 2 6 4 4 4 4 0 0 4
0 4 0 0 4 4 4 4 4 4 4 4 0 4 4 4 0 4 4 6 6 6 4 4 4 0 0 4 0
0 4 0 0 0 0 4 4 4 4 4 0 0 4 4 4 0 0 4 4 4 4 4 0 0 0 0 4 0
0 0 4 0 0 0 0 0 0 0 4 0 4 4 4 4 4 0 0 4 0 0 0 0 0 0 4 0 0
0 0 4 0 4 0 0 0 4 4 0 0 4 4 4 4 4 0 0 0 4 4 0 4 0 0 4 0 0
0 4 0 0 4 4 0 0 0 0 0 0 4 4 4 4 4 0 0 0 0 0 0 4 4 0 0 4 0
0 4 0 0 4 4 4 4 4 0 0 0 0 0 0 0 0 0 0 0 0 4 4 4 4 0 0 4 0
0 4 0 4 4 4 0 4 4 4 4 4 4 4 4 4 4 4 4 4 4 4 0 4 4 4 0 4 0
0 4 0 0 0 4 0 4 0 0 4 0 0 4 0 0 0 4 0 0 4 0 0 4 0 0 0 4 0
0 0 4 0 0 0 4 4 0 0 4 0 0 4 0 0 0 4 0 0 4 4 4 0 0 0 4 0 0
0 0 4 0 0 0 0 0 4 4 4 0 0 4 0 0 0 4 0 4 4 0 0 0 0 0 4 0 0
0 0 0 4 0 0 0 0 0 0 4 4 4 4 4 4 4 4 4 0 0 0 0 0 0 4 0 0 0
0 0 0 0 4 4 0 0 0 0 0 0 0 0 0 0 0 0 0 0 0 0 0 4 4 0 0 0 0
0 0 0 0 0 0 4 4 4 0 0 0 0 0 0 0 0 0 0 0 4 4 4 0 0 0 0 0 0
0 0 0 0 0 0 0 0 0 4 4 4 4 4 0 4 4 4 4 4 0 0 0 0 0 0 0 0 0